|------------------------------------------------------------------------------|
|                                 ECO   REPORT                                 |
|                                                                    Page   1  |
|------------------------------------------------------------------------------|
|  D:/Sankar/Personal/Final_Design_file/12v_12v_power_board/POWER.brd          |
|                                                    Fri Jun 04 19:15:01 2021  |
|------------------------------------------------------------------------------|
| NET CHANGES                                                                  |
|- - - - - - - - - - - - - - - - - - - - - - - - - - - - - - - - - - - - - - - |
|   net  name |  type of change |    pin_id     |   x   |   y   |   to  net    |
|- - - - - - - - - - - - - - - - - - - - - - - - - - - - - - - - - - - - - - - |
  GND          pins ADDED TO this existing net (pins not previously on any net)
                                 U1.9            -1011.3 626.808
|------------------------------------------------------------------------------|
|   total ECO changes reported  1                                              |
|------------------------------------------------------------------------------|
