|------------------------------------------------------------------------------|
|                                 ECO   REPORT                                 |
|                                                                    Page   1  |
|------------------------------------------------------------------------------|
|  D:/Sankar/Personal/Power_Board/POWER.brd                                    |
|                                                    Wed May 26 16:49:35 2021  |
|------------------------------------------------------------------------------|
| NET CHANGES                                                                  |
|- - - - - - - - - - - - - - - - - - - - - - - - - - - - - - - - - - - - - - - |
|   net  name |  type of change |    pin_id     |   x   |   y   |   to  net    |
|- - - - - - - - - - - - - - - - - - - - - - - - - - - - - - - - - - - - - - - |
  N20334246    net RENAMED (to net name listed on right)           N101734      
|------------------------------------------------------------------------------|
|   total ECO changes reported  1                                              |
|------------------------------------------------------------------------------|
